O F T W	PRODUCT
9492666866	DATE
Hyderabad	GPE
India	GPE
aanchal.jain1603@gmail.com	ORG
UX	ORG
May 2022 - December 2022	DATE
Blender	PERSON
Metaverse	ORG
UI	ORG
Blender	PERSON
Java	ORG
Spring Boot	PERSON
React	PRODUCT
2 weeks	DATE
Hyderabad	GPE
CSE	ORG
March 2022	DATE
L A	FAC
English	LANGUAGE
Telugu	PERSON
Kinara	GPE
Inc	GPE
QUANTIZED NEURAL NETWORK	PERSON
O F T W	PRODUCT
Kanban & XP	ORG
The Complete GitHub Actions &
	ORG
Coding
UI & Web Design	ORG
Adobe	ORG
University of Michigan	ORG
Coursera	ORG
University of California	ORG
Santa Cruz	GPE
Coursera	PERSON
Chronic Heart Failure	WORK_OF_ART
ML	PERSON
Deep Learning	WORK_OF_ART
Journal of Neuroscience	ORG
Quantum Physics	ORG
SQL	ORG
JavaScript
	PRODUCT
O F T W	PRODUCT
Adobe Photoshop	ORG
Adobe Illustrator	ORG
