Abhay Kamble	PERSON
Peth Vadgaon	PERSON
Academic Background  
 
 
	ORG
University/Board	ORG
Noida	GPE
2023	DATE
65%	PERCENT
Ashokrao Mane Group	ORG
Shivaji University	ORG
2019	DATE
59.70%	PERCENT
2015	DATE
64.70%	PERCENT
Y Highschool	PERSON
Kolhapur Board	ORG
2012	DATE
77.27%	PERCENT
JSP	ORG
Hibernate	ORG
C++	LANGUAGE
CSS	ORG
JavaScript	ORG
React JS	PERSON
Node JS	GPE
Express JS	ORG
jQuery	ORG
Microsoft	ORG
Linux	PERSON
GitHub	PERSON
Scrum	GPE
AWS	PERSON
Docker	PERSON
CAD/CAM  
	ORG
Maharashtra State Certificate in Information	ORG
Curricular	NORP
Debate Competitions	ORG
Annual	DATE
Problem Solving	PERSON
Swimming 
 
 
                                                                                 	EVENT
