Adnan Shakil Farrukh	PERSON
1990	DATE
28	CARDINAL
Beniapukur	ORG
Kolkata-700014	ORG
10B	ORDINAL
Anjuman Road	FAC
1	CARDINAL
Prime Watch	ORG
2	CARDINAL
British Council	ORG
Kolkata book Fair	EVENT
3	CARDINAL
P.S	GPE
West	LOC
Bengal University	ORG
4	CARDINAL
Editing Ilead	ORG
5	CARDINAL
Documentary Film	PERSON
6	CARDINAL
Ogilvy	ORG
Mather Mumbai	PERSON
Copywriter	LOC
7	CARDINAL
United Way Kolkata	GPE
Video Maker	PRODUCT
8	CARDINAL
Cinematographer and Social	ORG
92.7	CARDINAL
Mumbai	GPE
2018	DATE
December 2019	DATE
9	CARDINAL
Freelance Cinematographer	ORG
Social Media	ORG
Going to School (NGO	ORG
10.	DATE
Social Media	ORG
Facebook	ORG
Instagram	PRODUCT
Twitter	ORG
YouTube	PERSON
Google Ads and Analytics	ORG
11	CARDINAL
6 weeks	DATE
12	CARDINAL
Caring Minds	ORG
Institute of Mental Health (Contractual	ORG
2022
13	DATE
Milaap Org	ORG
April 2022	DATE
March 2023	DATE
2014	DATE
University of Technology	ORG
MAKAUT	ORG
M.Sc	ORG
Mass Communication Advertisingand	GPE
2010 - 2013	DATE
Punjab Technical University	ORG
PTU	ORG
B.SC Mass
Communication Advertising	ORG
Indian School	ORG
English	LANGUAGE
Hindi	GPE
Urdu	ORG
Bengali	NORP
Adobe Photoshop	ORG
Adobe	ORG
Nuendo	ORG
Pro X	PERSON
Registered Drone Pilot	PERSON
Drone Pilot	PERSON
Nuendo	GPE
Pro X
iii	PERSON
Organized Film	PERSON
Ilead	GPE
“Night of January 16”	WORK_OF_ART
Digital Film Making	ORG
Certificate	ORG
Indo French Film	ORG
Ogilvy	ORG
Mather	PERSON
a Positive Feedback	ORG
1st Prize	WORK_OF_ART
Ad Spoof	WORK_OF_ART
Prahlad Kakkar	ORG
Award Winner	WORK_OF_ART
Nez International Film Festival	EVENT
World Showcase Film	WORK_OF_ART
GoPro	ORG
Flare Studio London	ORG
Certificate of Festival Special Mention atChambal	ORG
International Film Festival	EVENT
Bhutan	GPE
Certificate of Official Selection	ORG
Chambal International Film	ORG
International Film Festival	EVENT
Cinematic Vlogs	PERSON
YouTube Channel
	PERSON
Twitter Page	PERSON
ARB2nJVzCYOa_bVtFQ2iho-	ORG
7nMjB0CizLSxaBcW1uODHtEtErPR-L-	QUANTITY
Spiti Winter Expedition	ORG
Bhutan Travel Film Music Video	EVENT
Video	ORG
Video	ORG
Victoria Memorial - Kolkata - Travel	PERSON
Hyderabad Golconda	PERSON
Fort Travel Film	EVENT
ABU	ORG
Kolkata	PERSON
Green taxi Film	WORK_OF_ART
3	CARDINAL
Dhun Badal	PERSON
Rap Song	PERSON
VidyaBalan	FAC
