London	GPE
07908596329	DATE
London	GPE
BA Hons	ORG
English	LANGUAGE
the English Department	ORG
2:1	CARDINAL
Second Year	DATE
Durham Johnston Comprehensive School	ORG
A Level:	WORK_OF_ART
English	LANGUAGE
English	LANGUAGE
Geography	PERSON
English	LANGUAGE
Modern Greek	NORP
9/16-6/17	CARDINAL
3	CARDINAL
9-6	PRODUCT
Maths	PRODUCT
English	LANGUAGE
06/22	CARDINAL
Client Services	ORG
Solutions	PRODUCT
Success Analysts	ORG
Success	ORG
Investors Analyst	ORG
Similarweb	ORG
Nestle	PERSON
Carrefour	ORG
the Marketing Department	ORG
Rank Ranger	PERSON
over 20	CARDINAL
2	CARDINAL
Phillips DA Netherlands	ORG
Phillips	ORG
50	CARDINAL
2 Blitz days	DATE
50	CARDINAL
20%	PERCENT
the month of July	DATE
Similarweb	ORG
the Principal Client	GPE
Success Analyst	ORG
Content Creator	PERSON
StudySmarter	ORG
09/21-02/22	CARDINAL
80	CARDINAL
English	LANGUAGE
Ryte	PERSON
100	CARDINAL
4000	CARDINAL
PayPal	NORP
Super App	GPE
10	CARDINAL
8	CARDINAL
AI	GPE
Blockchain	GPE
5	CARDINAL
Mastercard	ORG
PayPal	GPE
Onfido	GPE
Grayce	PERSON
Research and Welfare	ORG
Bentham Brooks Institute	ORG
04/21-04/22	CARDINAL
5	CARDINAL
UCL	ORG
monthly	DATE
monthly	DATE
Methodological and Topical	ORG
2 months	DATE
35%	PERCENT
Cambridge Journal of Law	ORG
over 20	CARDINAL
Over 10,000	CARDINAL
the Cambridge Editorial Handbook	ORG
Arts	WORK_OF_ART
over 440	CARDINAL
Journal	ORG
London	GPE
Cambridge	GPE
9/20	CARDINAL
TGROW	ORG
the British Association for Coaching	ORG
weekly	DATE
app	ORG
SimplyLocal	ORG
Bangladeshi	NORP
Brick Lane	FAC
Bangladeshi	NORP
Thinking Local, Thinking of You	WORK_OF_ART
nine	CARDINAL
third	ORDINAL
nine	CARDINAL
09/21-10/21	CARDINAL
six-week	DATE
SMART	NORP
ROI	PRODUCT
HCI	ORG
HTML	GPE
CSS	ORG
JavaScript	ORG
weekly	DATE
digital labs	ORG
uCertify	ORG
3	CARDINAL
European	NORP
Brexit	GPE
second	ORDINAL
Britain	GPE
the European Parliament	ORG
EU	ORG
European	NORP
European	NORP
