Arundhati Nandi	PERSON
Social Media Marketing Consultant	ORG
West Bengal	GPE
India	GPE
2022	CARDINAL
Midas Touch Consultants	WORK_OF_ART
Social Media Marketing Consultant	ORG
5	CARDINAL
US	GPE
B2B Technology	ORG
UI/UX	ORG
Big Data	ORG
SNOW	ORG
AI/ML	ORG
Social Media Copy Writing and Creative Designing	ORG
Twitter	ORG
Instagram	GPE
Facebook	ORG
Marketing Mix	PERSON
Tools - Creator Studio | SocialPilot | TweetDeck | Canva
	WORK_OF_ART
Oct 2021	DATE
Social Media	ORG
Social Media	ORG
Zee Bangla Cinema	ORG
Bengali Entertainment	ORG
Facebook	ORG
Instagram	PRODUCT
Stakeholder Management	ORG
Designing Team	ORG
Social Media Report	ORG
2019 - 2021	DATE
The Heritage Academy	ORG
Kolkata	PERSON
Media Science, Grade	ORG
8.42/10	CARDINAL
2016 - 2019	DATE
Rani Birla	PERSON
University of Calcutta	ORG
Journalism and Mass Communication	WORK_OF_ART
Honours	ORG
BDM International	ORG
AISSCE - Commerce with Business Studies	ORG
10	CARDINAL
2014	DATE
Holy Cross School	ORG
CISCE	ORG
Social Media Marketing - 3	ORG
Genre: Jewellery and FMCG Industry	WORK_OF_ART
Content Writing: Successfully	WORK_OF_ART
250	CARDINAL
4	CARDINAL
Genre: Blogs (Fashion	WORK_OF_ART
InDesign | Final Cut Pro | Canva | Microsoft Office - Word	PRODUCT
Excel	PRODUCT
PowerPoint	ORG
Technical	ORG
Ad-Adda	WORK_OF_ART
Marketing Communication Event	ORG
The Heritage Academy	ORG
Kolkata	GPE
a Short Film Festival	EVENT
Mini Input	WORK_OF_ART
the Department of Media Science	ORG
The Heritage Academy	ORG
4th year	DATE
Fine Arts (Painting	WORK_OF_ART
Kala Kendra	PERSON
