7386855669	DATE
2+ years	DATE
Flask	NORP
MS SQL	ORG
Firebase FireStore	PERSON
GCP	ORG
Cloud Functions	ORG
Cloud Storage	ORG
Databricks	PERSON
Docker	PERSON
Git	PERSON
Postman	GPE
HTML	ORG
CSS	ORG
JS	ORG
Google Analytics	ORG
Firebase Analytics	ORG
Big Query	ORG
Data Studio	PERSON
Tableau	ORG
1 Year 11 Months	DATE
21	CARDINAL
Python	ORG
FASTAPI & FLASK	ORG
Leveraged Flutter's	PERSON
Managed Firebase	PERSON
Google Cloud Platform	ORG
ETL	ORG
MLDL	ORG
Learn AR - Core Developer	ORG
8 Months	DATE
20	CARDINAL
21	CARDINAL
AR	ORG
Flutter with Unity Integration	PRODUCT
Managed Firebase	PERSON
Google Cloud Platform	ORG
User Analytics	ORG
UIUX	ORG
User Onboarding	PERSON
Lagaland LLP - Software Developer Intern	PERSON
2 Months	DATE
20	CARDINAL
Jun	PERSON
20	CARDINAL
Board/University	ORG
2021	DATE
IIT	ORG
6.72	CARDINAL
2016	DATE
XII	ORG
Board of Intermediate	ORG
Andhra Pradesh	GPE
93.2%	PERCENT
2013 - 2014	DATE
9.5 / 10	CARDINAL
three	CARDINAL
Monolithic	GPE
Microservice	GPE
