IBM India Pvt Ltd	ORG
Vinturas	WORK_OF_ART
Agile	ORG
Hyperledger	ORG
IBP	ORG
VS Code IDE	PRODUCT
Docker	PERSON
Hyperledger	ORG
Jest	ORG
CI	ORG
n8n.io	CARDINAL
Kubernetes	GPE
Blockchain Training Alliance	ORG
Certified Blockchain Developer Ethereum	ORG
Solidity	ORG
Remix IDE	PERSON
Truffle	GPE
Ganache	GPE
Ether Scan	PERSON
IBM	ORG
JAVA	ORG
Microsoft	ORG
NIT Kurukshetra	ORG
Haryana	PERSON
Power Electronics	ORG
Diploma (Industrial Automation	ORG
Prolific Systems & technology	ORG
Noida	ORG
Diploma	ORG
Badarpur	GPE
New Delhi	GPE
78 / 100	CARDINAL
IMS Engineering Collage	ORG
78 / 100	CARDINAL
AI / ML Models	ORG
D DevOps & CI	ORG
A Full Stack Development	WORK_OF_ART
8447447076	DATE
6261197932	DATE
CSS	ORG
Bootstrap	GPE
JS	GPE
TypeScript	ORG
Angular	ORG
Typescript	GPE
NodeJS	GPE
NestJS	ORG
JAVA	ORG
Spring Boot	GPE
JUnit	GPE
Docker	PERSON
Docker	PERSON
Kubernetes	GPE
k9s	GPE
Hyperledger Fabric	PERSON
IBP	ORG
DL & AI	ORG
NumPy	GPE
Keras	GPE
Eli5	ORG
TensorFlow	ORG
PyTorch 
Data Visualization & Processing	ORG
MS Excel	PERSON
AWS	ORG
MS Azure	ORG
IBM	ORG
Couch DB	PERSON
Mongo DB	PERSON
SAFE	ORG
LEAN	ORG
Agile	GPE
Scrum	GPE
Postman	NORP
& Event	ORG
IBM	ORG
Kurukshetra	PERSON
2015 - NPTI	DATE
Badarpur	GPE
Software Developer	PERSON
Faizabad	PERSON
Noida	PERSON
Manish Thaper	PERSON
500	CARDINAL
Digital Technology Leadership	ORG
