Bhaumik Tandan	PERSON
	PERSON
Vellore Institute of Technology	ORG
India	GPE
Developed Interest in Web Development	ORG
SnappiTech	ORG
January 2021‑October 2021	DATE
October 2021‑Mach 2022	DATE
April	CARDINAL
Java	ORG
JavaScript	ORG
Ruby	PERSON
C++	DATE
Android Studio	PERSON
Git	PERSON
Linux	PERSON
SQL	ORG
Numpy	PERSON
Pandas	LOC
React Native	ORG
SqlLite for Database	ORG
SQL	ORG
Online Compiler	PERSON
MERN	PERSON
JS	ORG
CSS	ORG
