Debarshi Hafila	ORG
Neighborhood Planning	ORG
Transport Planning	ORG
Site Planning	ORG
Area Planning	ORG
Master Planning	ORG
Regional Planning	ORG
{ï¿½ Site Planning at Dwarka	WORK_OF_ART
New Delh	GPE
2	CARDINAL
Delhi	GPE
Air Pollution	EVENT
3	CARDINAL
Eco Sensitive Zone	GPE
Park & Tiger Reserve	ORG
2021-23	DATE
School of Planning and Architecture	ORG
New Delhi	GPE
GIS	ORG
Guwahati	PERSON
Assam	PERSON
AICTE	ORG
MOEFCC	LOC
Debarshi Hafila	ORG
Planing History & Theory	ORG
Socio - Economic Base	FAC
Infrastructure & Transport Planning	ORG
Housing & Environmental Planning	ORG
Demography & Statistical	ORG
Environmental Monitoring	WORK_OF_ART
Environmental Economics & 
	ORG
Environmental Protection	ORG
Environmental and Planning	ORG
