Divyam Makhaik	PERSON
7876068844	CARDINAL
India	GPE
makhaik-6bab95196	CARDINAL
Linux	PERSON
Nodejs 
	PERSON
SQL	ORG
English	LANGUAGE
Chandigarh University	ORG
Frytx	GPE
Admin	PERSON
TailwindCSS	PERSON
Nodejs(Express	CARDINAL
jpg	PERSON
jpeg	PERSON
word	GPE
Nodejs(Express	CARDINAL
EJS	ORG
VS CODE IDE	PERSON
PostMan	ORG
https://github.com/divyammakhaik01/Share-IT	ORG
EJS	ORG
tailwind CSS	PERSON
VS Code IDE	PERSON
OOP	ORG
edit_product	ORG
delete_product	GPE
Sublime Text 3	PRODUCT
