SUMMARY	ORG
Rahul Singh	PERSON
Deoria	GPE
Uttar	GPE
Linkedin	PERSON
Full Stack Developer	WORK_OF_ART
04/2022-present	CARDINAL
Prasad Institute of Technology	ORG
React | Redux |	PRODUCT
Bharat Electronics Limited	ORG
Ghaziabaad	PERSON
07/2019-08/2020	CARDINAL
Technical	WORK_OF_ART
CSS	ORG
JavaScript	ORG
Landing Page	PERSON
TutorialsPage	ORG
CSS	ORG
JavaScript	ORG
Delete	PERSON
JavaScript | Html | CSS |
Team-Work 
	PRODUCT
Alogrithms	PERSON
English	LANGUAGE
