RenewRisk	ORG
UK	GPE
Digital	ORG
Birmingham	GPE
UK	GPE
Al Wazan Group	ORG
UAE	GPE
Excel	PRODUCT
daily	DATE
Morganti Group	ORG
Inc	ORG
UAE	ORG
2017	DATE
Msc Digital Marketing	FAC
Northumbria University	ORG
London	GPE
UK	GPE
Bahria University	ORG
Karachi	PERSON
Pakistan	GPE
Saadiyat	NORP
daily	DATE
Maximo	ORG
PPM	ORG
daily	DATE
Business Dev	PERSON
Pakistan	GPE
Google Analytics	ORG
English	LANGUAGE
Lotte Chemicals ltd	ORG
Pakistan	GPE
Brief Market Research	ORG
International Vendor Research	ORG
weekly	DATE
Bahria Society of Professional 
Communication	ORG
BSPC	ORG
Karachi Fiesta	PERSON
Bahadurabad club	ORG
Karachi	PERSON
Danzzeh	WORK_OF_ART
Karachi fiesta	PERSON
Bahadurabad	PERSON
Karachi	PERSON
