8088440132	DATE
College/School	ORG
CSE	ORG
June 2023	DATE
6.60	CARDINAL
2019	DATE
Narayana Junior	PERSON
9.0	CARDINAL
CGPA	ORG
10th
	DATE
9.7	CARDINAL
CGPA	ORG
House	ORG
1 year	DATE
1 year	DATE
Robinhood Army	ORG
1 year	DATE
Java Script	PERSON
Online Medical Booking	WORK_OF_ART
Solving(Intermediate	CARDINAL
CSS - HackerRank Certificate	ORG
Python - Coursera - Google	ORG
Programming for Everybody (Getting	WORK_OF_ART
Python	WORK_OF_ART
Coursera - University of Michigan	ORG
Python Data	ORG
Coursera - University of Michigan	ORG
Divide and Conquer, Sorting and Searching	WORK_OF_ART
Randomized	PERSON
Algorithms - Coursera-Stanford University	PERSON
Front-End Development - Coursera - Meta	ORG
Python - Coursera - Meta	ORG
Birth	PERSON
Lingareddy Murali Krishna Reddy	PERSON
Lingareddy Radhika	PERSON
Indian	NORP
English	LANGUAGE
Telugu - Native	FAC
Hindi - Full	PERSON
Kannada	GPE
Krishna Reddy	PERSON
66	CARDINAL
4th	ORDINAL
Kanakapura	GPE
Banashankari Metro Station	FAC
Shakambari Nagar	PERSON
Bengaluru	PERSON
Karnataka	PERSON
560078	CARDINAL
