Time	ORG
H.NO:175,Suraram(V	DATE
English	CARDINAL
PHP	ORG
JSP	ORG
JavaScript	ORG
CSS	ORG
app	ORG
GPS	ORG
Hyderabad	GPE
54.07%	PERCENT
Govt Polytechnic	ORG
Warangal	PERSON
Diploma	GPE
Dcme	PERSON
2015	DATE
66.52%	PERCENT
C++,java	ORG
jsp	ORG
Java script.and	ORG
Mahadevpur	PERSON
Tutorial on Artifical Intelligence:	WORK_OF_ART
