Fortabbas	PERSON
Bahawalnagar	GPE
Punjab	GPE
Pakistan	GPE
KRL Institute of Technology Kahuta	ORG
MA	ORG
2013 - 2016	DATE
2019
2019-2021	DATE
Social Media Marketing	ORG
Social Media Marketer	ORG
more than 3 years	DATE
DM	ORG
Social Media	ORG
Social Media	ORG
Facebook	ORG
YouTube	PRODUCT
Instagram	PRODUCT
Facebook	ORG
Facebook	ORG
Instagram	PRODUCT
Shopify Facebook	PRODUCT
Google	ORG
Email Marketing	ORG
the past 3 years	DATE
SMM	ORG
Facebook Ads	PERSON
Email	ORG
Skype	ORG
60 working hours	TIME
