India	GPE
Responsive	ORG
DNS Changer Application	ORG
DNS	ORG
IP	ORG
Data Analysis	ORG
Microsoft Power BI Tool	ORG
03/2022	CARDINAL
Android Developer | SSJ IT	PERSON
Ltd | Ghaziabad	PERSON
MyNaav- A	PERSON
App	ORG
Varanasi	PERSON
06/2021 - 09/2021  
	PERCENT
Java	ORG
HTML	ORG
PHP	ORG
Linux	PERSON
up to 60	CARDINAL
EDUCATION	ORG
2019 - 2023	DATE
Performer	PERSON
CSE Branch	ORG
IMSEC	GPE
88.72 %	PERCENT
2017 - 2018	DATE
Intermediate | SS Children Academy Girls School | Moradabad	PRODUCT
78.8 %	PERCENT
Core Java  
	ORG
CSS	ORG
PHP	ORG
Database	PERSON
Android Development 
	PERSON
Microsoft Power BI Tool  
	ORG
Linux	PERSON
OAuth	PERSON
OAuth	ORG
4.0	CARDINAL
Hardware	PRODUCT
KNN	ORG
8 seconds	TIME
MyNaav-Boat Booking Application	ORG
Varanasi	GPE
60	CARDINAL
IBM	ORG
ICT Academy	ORG
SQL	ORG
RELATIONAL DATABASE	PERSON
IBM	ORG
Artificial Inteligence Virtual Exp	WORK_OF_ART
Java Training	PERSON
EDUCBA	ORG
Great Learning Academy	ORG
Responsive Website	ORG
EDUCBA	ORG
