Pankaj Gurung Phone	PERSON
07881095917	CARDINAL
2023	CARDINAL
Marketing Communication - University of the West	ORG
England	GPE
2014 - Bachelor of Arts	PERCENT
First	ORDINAL
Mahachulalongkornrajavidyalaya	ORG
Ayutthaya	ORG
Thailand	GPE
2019	CARDINAL
Diploma	GPE
Nakhon Nayok	ORG
Thailand	GPE
Ashrampara	GPE
Siliguri	GPE
W.B	GPE
India	GPE
2022	CARDINAL
February	DATE
Bristol England	ORG
2022(April	TIME
December	DATE
Bristol	GPE
England	GPE
2016	DATE
Teacher - Sunsermwit School	ORG
Bang Phli	PERSON
Samut Prakan	PERSON
Thailand	GPE
Observe	NORP
G.S.A Front	ORG
Hotel Princeton Bangkok	FAC
Ding Daeng	PERSON
Bangkok	GPE
Thailand	GPE
Chid Lom	PERSON
Bangkok	GPE
Thailand	GPE
Skills - Microsoft	ORG
Video	ORG
Photography, Customer service	ORG
Cut Pro X	PERSON
English	LANGUAGE
Nepali	LANGUAGE
Hindi	GPE
Bengali & Thai	ORG
