Rahul Thatar	PERSON
Kharghar Navi	PERSON
Mumbai	GPE
India	GPE
Saraswati College of Engineering Kharghar	ORG
SVD Junior College	ORG
2018 - 2020	DATE
Maharashtra	ORG
65%	PERCENT
Mahatma Gandhi Vidhya Sankul	PERSON
2017 - 2018	DATE
Gujarat	GPE
82%	PERCENT
JAVA	ORG
Javascript 
	PERSON
SQL	ORG
SPORTS EVENTS APP	WORK_OF_ART
Java And Firebase	WORK_OF_ART
Java	ORG
Admin Page	PERSON
MYSQL	ORG
Udemy	GPE
Android Mobile App Developer	PERSON
