JAVA-SpringBoot & React Framework	ORG
Summer Internship - BeatO	FAC
HealthARx technologies private Ltd	ORG
Java	ORG
Kotlin	GPE
Develop & Design	ORG
Programming Languages & Framework	ORG
Java-SpringBoot & C++	ORG
Oracle	ORG
CSS3	ORG
JavaScript, React & BootStrap Framework	ORG
Visual Studio Code	PERSON
NetBeans	NORP
Eclipse IDE	PERSON
Postman	GPE
Jupyter Notebook	PERSON
/Backend Application Development	ORG
HTML5	GPE
CSS3	PERSON
BootStrap, React & Spring Boot Frameworks	ORG
Collaborative Environments	ORG
Strong Time Management	ORG
Master's in Computer	WORK_OF_ART
7.55	CARDINAL
2019-2022	DATE
Mumbai University	ORG
Computer	GPE
7.55	CARDINAL
2016-2019	DATE
Tilak Maharashtra Vidyapeeth	PERSON
Pune university	ORG
Flutter (Dart Language	ORG
Visual Studio Code	PERSON
Postman	GPE
