Rajarshi Chatterjee	PERSON
H20210041	ORG
BITS Pilani K K	PERSON
Birla Goa Campus	PERSON
Linkedin	PERSON
Degree/Certificate
Institute/Board	ORG
CS	ORG
BITS Pilani	PERSON
Goa	PERSON
2021-Present	CARDINAL
CSE	ORG
Kattankulathur	PERSON
2017-2021	DATE
Secondary	ORDINAL
WBHSCE Board	ORG
ICSE Board	ORG
Writingo	GPE
March	DATE
2023	CARDINAL
India	GPE
GPT-4	PERSON
Claude	PERSON
Generative AI	GPE
Techolution	PRODUCT
Jan. 2023 - Feb. 2023	DATE
India	GPE
ASR	ORG
ASR	ORG
GCP	ORG
BITS Pilani	PERSON
Pilani	PERSON
Summer Research Intern	ORG
Pilani	PERSON
Rajasthan	GPE
India	GPE
Indian	NORP
Indian	NORP
English	LANGUAGE
Indian	NORP
May 2022 - Jun 2022	DATE
India	GPE
BERT	ORG
LinkBERT	ORG
QA	GPE
Car Price Prediction	WORK_OF_ART
Dec. 2021	DATE
app	ORG
88 %	PERCENT
Tools & technologies	ORG
BeautifulSoup	ORG
Python, Pandas	ORG
Kaggle	ORG
Jan. 2022	DATE
yolov5s	CARDINAL
Feb. 2023	DATE
GPT-3	PRODUCT
Data Structures	ORG
Algorithms	PERSON
DBMS	PERSON
Computer Networks, Pattern	ORG
Recognition	ORG
Python	ORG
SQL	ORG
Tools & OS: Git	ORG
Jupyter Notebook	GPE
Google Colab	ORG
PyCharm	GPE
VSCode	ORG
Linux	PERSON
Numpy	PERSON
PyTorch	LOC
NLTK	ORG
Hugginface	PERSON
Responsibility	ORG
Teaching Assistant,Fundamentals of Data Science	WORK_OF_ART
BITS Goa	PERSON
January 2022	DATE
Research Practice	WORK_OF_ART
Biologically-Inspired Neural Nets	ORG
BITS Goa
	ORG
September 2021 - December 2021	DATE
Secured AWS AI & ML Scholarship	ORG
2022	CARDINAL
Python	ORG
IIT	ORG
Deep Learning Specialisation	WORK_OF_ART
