New Delhi	GPE
Deloitte	ORG
USI	ORG
2	CARDINAL
14 months	DATE
Performed EDA	PERSON
Umap	GPE
ClearTax	ORG
Bangalore	GPE
Software Engineer	PERSON
4 months	DATE
Bharat Electronics Limited	ORG
Central Research Laboratory	ORG
34 months	DATE
Weapon Assignment(WA	PERSON
Integrated Air Command	ORG
Control System Phase-V	ORG
IACCS-V	ORG
C++	LANGUAGE
Threat Evaluation	ORG
Database	PERSON
WA	ORG
MATLAB	PERSON
CRS	ORG
WA	ORG
IBM Doors & IBM Raphsody	ORG
Tectura Infotech Pvt. Ltd.	ORG
Noida                                                                                           
 
Associate Software Developer	PERSON
6 months	DATE
ERP	ORG
Microsoft Dynamics Axapta	ORG
2012	DATE
Kanpur	PERSON
Bi-Directional	ORG
Kanpur	PERSON
Twitter	ORG
Twitter	ORG
Ethereum Blockchain	ORG
Blockchain Technology and Application	ORG
Kanpur	PERSON
Computational Cognitive Science |IIT Kanpur	WORK_OF_ART
Normalized Google Distance	WORK_OF_ART
two	CARDINAL
2020	DATE
2022	DATE
Facebook	ORG
2019	DATE
24th	ORDINAL
Automatic Graph Representation Learning	FAC
KDD Cup 2020	EVENT
ChaLearn	ORG
Stanford	ORG
Google	ORG
1802	DATE
HackerRank	ORG
1571	DATE
HackerEarth	ORG
Google Kick Start Round G 2019	WORK_OF_ART
Qualified for Round 3 of IndiaHacks 2017:	WORK_OF_ART
HackerEarth	ORG
Won 1 Silver	ORG
3	CARDINAL
Bronze	ORG
HackerRank	ORG
4837	CARDINAL
HackerEarth Machine Learning	ORG
HackerEarth	ORG
SnackDown	PRODUCT
2017	DATE
CodeChef	ORG
2951	DATE
SnackDown Online	PERSON
Secured	ORG
International Informatics Olympiad	ORG
XII	ORG
Delhi Public School	ORG
Kanpur	PERSON
M.S.	GPE
Computer 
Science & Engineering	ORG
2020	DATE
Computer Science & 
Engineering	ORG
2013	DATE
Jaypee University of Engineering and  
Technology	ORG
C++	LANGUAGE
Python	ORG
SQL	ORG
MATLAB	ORG
Core Java	PERSON
HTML	ORG
Pandas	LOC
Keras	GPE
Numpy	PERSON
Power BI	PRODUCT
Tableau	ORG
Red Hat	PERSON
Linux	PERSON
Algorithms	PERSON
Data Structures	ORG
Deep Learning	ORG
CERTIFICATIONS	ORG
Stanford	ORG
Coursera  
ï‚·	ORG
Coursera	ORG
Algorithms	PERSON
Stanford	ORG
Online	PRODUCT
Udemy	GPE
Core Java	ORG
Hewlett-Packard 
	ORG
Education Services	ORG
Kanpur   
	PERSON
Linux	PERSON
Hewlett-Packard 
	ORG
Education Services	ORG
Kanpur	PERSON
Noida 
 
	PERSON
GraphReach	ORG
Graph Neural Network	ORG
Reachability Estimations	ORG
International Joint Conference	WORK_OF_ART
2021	DATE
Montreal	GPE
Canada	GPE
upto 40 percent	PERCENT
ROC	GPE
AUC scores	PRODUCT
PGNN	ORG
GCN	ORG
GAT & GIN	ORG
Lexical	ORG
Parser	ORG
CBOOP	ORG
International 
Organization of Scientific Research 
	ORG
Journal of Computer Engineering	ORG
Vol	PERSON
May-Jun 2013	DATE
