YOGANATHAN A,	ORG
B.E.	GPE
Mechanical Engineering	ORG
247	CARDINAL
Bamparapattiyanoor	ORG
Pottiyapuram	PERSON
omalur	PERSON
Salem-636309	ORG
9994113161	DATE
Marks 
 
	PERSON
Sri Krishna College	PERSON
ANNA	PERSON
CGPA	ORG
86%	PERCENT
School, Mettur	ORG
APRIL	CARDINAL
77%	PERCENT
Query Language)	PERSON
Cognizant Technology	WORK_OF_ART
Programmer Analyst Trainee 
	PERSON
Oracle Apps Database Administrator	PERSON
Patching, Cloning	WORK_OF_ART
Backup	PERSON
Windshield Wiper Mechanism	ORG
screen.	ORG
Hoverboard	GPE
System	ORG
one	CARDINAL
Al 6061 Metal	ORG
Aluminium, Grade : Aluminium	ORG
6061	CARDINAL
this project.
 
	ORG
Journal	ORG
Al 6061 Metal	ORG
Scopus.com	ORG
two weeks	DATE
Overall Championship	ORG
Quad	GPE
CAE	ORG
Maneuverability, Acceleration, Overall Static	ORG
player.	ORG
environment.
	FAC
situation.	ORG
Birth	PERSON
English	LANGUAGE
Tamil	PERSON
Arjunan	GPE
Sagunthala	PERSON
