PRASHANT RAMESH	PERSON
B.E.	PERSON
2022	DATE
7038170634	CARDINAL
8.02	CARDINAL
INSTITUTE/COLLEGE
	ORG
XII	ORG
Bharati Vidyapeeth	PERSON
92.6 %	PERCENT
City International School	ORG
9.2	CARDINAL
Java, Python	ORG
HTML	ORG
CSS	ORG
JavaScript	ORG
Node.js	GPE
SQL	ORG
Firebase	PERSON
Git	PERSON
AWS	PERSON
Linux	PERSON
Shell	ORG
Docker	PERSON
GIS	ORG
Watson	GPE
Web Scraping	PERSON
Microsoft Excel	PERSON
MATLAB	ORG
X86 Assembly	ORG
Media.net	ORG
May 2023	DATE
May 2020 - Jun 2020	DATE
Graph Theory (Alignment	ORG
Image Processing (Super Resolution	ORG
PyTorch	ORG
GIS	ORG
GeoJSON	ORG
Git	PERSON
Linux	PERSON
Docker	PERSON
SMS Classification	ORG
the FinPal Community	ORG
SQL	ORG
JavaScript	ORG
Scrapy	PERSON
Excel	PRODUCT
Jun 2020 - Aug	PERSON
2020	DATE
IPFS	ORG
Truffle	GPE
MERN	PERSON
Web3 Hacks	LOC
QuestBook	ORG
IBM Watson	PERSON
PushBot	ORG
mongoDB	PERSON
nodeJS	PERSON
Bootstrap	PERSON
Heroku	GPE
Asia	LOC
Programmer	GPE
Asia	LOC
32	CARDINAL
the Better Health Hackathon	ORG
#CodeForCovid19	MONEY
Google Cloud	ORG
SigmaHacks	ORG
BITS	ORG
Goa | Github	PERSON
CSS	ORG
Bootstrap	ORG
JavaScript	ORG
mongoDB	PERSON
Scrapy	PERSON
Excel	PRODUCT
2000	DATE
1	CARDINAL
Crack	GPE
Crisis Hackathon	FAC
Jun	PERSON
2020	DATE
9	CARDINAL
Cisco	GPE
Oct, 2020	DATE
50	CARDINAL
National Engineering Olympiad	ORG
2020	DATE
1	MONEY
IBM	ORG
NASSCOM 
 
	ORG
Cisco	GPE
APJC CTF	PRODUCT
India	GPE
Second Year Engineering	EVENT
National Engineering Olympiad	ORG
3.0
	PRODUCT
Network Representative - Council for Student Affairs	ORG
2019	DATE
Linux	PERSON
Center for Technical Education BITS	ORG
7.95	CARDINAL
