Matthew Panakal	PERSON
13	CARDINAL
Bollineni	NORP
Adobe Premiere	ORG
Pro X	PERSON
Cut Pro	PERSON
Ableton Live	PERSON
Reaper	PERSON
Davinci Resolve	PERSON
Aditi Mittal	PERSON
Amazon MiniTV	PRODUCT
Aditi Mittal	PERSON
2021 - 2022	DATE
India	GPE
Amazon	ORG
Amazon Mini TV	ORG
YouTube	PRODUCT
India	GPE
2022	CARDINAL
Trinity	ORG
Karate	NORP
Chennai	GPE
TUTOR	ORG
KARATE INSTRUCTOR	PERSON
Timbre School of Music	ORG
Gurukulam Shito	PERSON
Ryu Karate	PERSON
2020 - 2022	DATE
2017 - 2019	DATE
B.sc	CARDINAL
Visual	GPE
Media College	ORG
2023	DATE
KNOWLEDGE	ORG
Adobe Premiere	ORG
Apple	ORG
Pro X	PERSON
Ableton Live	PERSON
Cut Pro	PERSON
Davinci Resolve	PERSON
