Ibrix Pvt Ltd	ORG
RAI	ORG
AZURE|GCP BIG	ORG
6 Months	DATE
6 Months	DATE
Data Visualization & ETL	ORG
Over 1 Year	DATE
Machine Learning	ORG
AI-ANN	ORG
Academics	NORP
SQL	ORG
India	GPE
8150005306	DATE
LinkedIn Profile	ORG
SQL	ORG
Power BI	ORG
Excel	PRODUCT
DocVita Inc |Web Developer	PERSON
Oct 2020-	DATE
Docvita.com	ORG
Google AdWords	PRODUCT
Google Analytics	ORG
WordPress	ORG
Bricks Sales Insight	ORG
Power BI & MySQL	ORG
Workbench	PRODUCT
12000	CARDINAL
Extract Transformation Load	ORG
Power BI	ORG
Done Data Modeling like Star	ORG
Snowflakes Schema	ORG
Workbench	PERSON
Roles & Responsibilities	ORG
2021 - Feb 2022	DATE
Symbiosis Institute of Computer Studies and Research (SICSR	ORG
Data Analysis	ORG
Machine Learning Algorithms|Computer Vision, Image Processing	ORG
7.5	CARDINAL
Garden City University	ORG
ICAIML - 2019	ORG
Core Web Development | Python	ORG
| 3 Months	DATE
3 Months	DATE
8.45	CARDINAL
June 2021	DATE
Karnataka	PERSON
July 2018	DATE
Maharashtra	ORG
April 2023	DATE
Research & POC:	ORG
Analysis	WORK_OF_ART
4	CARDINAL
CDC	ORG
Survey Data	ORG
Performed EDA	PERSON
4	CARDINAL
more than three	CARDINAL
Boosters & Confusion Matrics	ORG
Roles & Responsibilities	ORG
June '22 - Dec'22	DATE
Programming Languages: Python	WORK_OF_ART
CNN	ORG
RNN	ORG
LSTM	ORG
SVM	ORG
DT	GPE
Keras	GPE
PyTorch	GPE
MS Excel	PERSON
Power BI	ORG
Looker Studio	PERSON
Tableau	ORG
Jupyter	ORG
Numpy	PERSON
TensorFlow	ORG
Keras	GPE
BIG Data Technologies	ORG
BIG Query	ORG
GCP	ORG
Microsoft Azure	ORG
GCP	ORG
Skills | MS Office	ORG
English	LANGUAGE
Hindi	PERSON
Marathi (Beginner	ORG
Spanish	NORP
Beginner	PERSON
13	CARDINAL
