India	GPE
Flask	GPE
YOLO v5	LAW
20%	PERCENT
May 2022 - Present	DATE
Harman Connected Service	ORG
Flask	LOC
JavaScript	ORG
React JS	PERSON
EDA	ORG
Pandas, Matplotlib	ORG
DS	ORG
Git	PERSON
Smart Airport	FAC
Airport	GPE
next 24 hours	TIME
the India Festival Python	EVENT
Indian	NORP
Core Python	PERSON
Git	PERSON
Python Project	ORG
Flask	NORP
Pipeline	WORK_OF_ART
1	CARDINAL
5	CARDINAL
HackerRank	ORG
Numpy	PERSON
Seaborn	GPE
OS	GPE
Glob	GPE
2	CARDINAL
SQL	ORG
3	CARDINAL
GitHub	NORP
4	CARDINAL
7	CARDINAL
CSS	ORG
JS	ORG
Anaconda	PERSON
PIP / CONDA	ORG
AISSMS Institute	ORG
8.85	CARDINAL
9	CARDINAL
