2013 - 2015	DATE
Pune University Bachelor	ORG
Mass Media	GPE
2009 - 2011	DATE
Mass Media& Sound Engineering	ORG
Video Editor & Motion Graphics Artist	ORG
TrueFan	GPE
LearnVectors	ORG
Parth Knowledge	ORG
Video Editor & 2D	ORG
Jaro Toppscholars	PERSON
NMTV	ORG
Jai Maharashtra News Channel	ORG
Recording and Mixing Sound	ORG
Shorts Film	PERSON
Freelancing Mixing & Mastering Songs	ORG
Adobe	ORG
FCP X	ORG
FCP	ORG
Adobe Premiere	ORG
Adobe Audition	ORG
Pro X	PERSON
Ableton	GPE
Sagar Gupta - O Saajana	PERSON
Friendship Medley	PERSON
Aisha - Kahe Banaye Batiyan	PERSON
Imran Khan &	ORG
Video Link	PERSON
Ashok Nagar	PERSON
Datar Colony	GPE
Mumbai - 400042	ORG
Sagar Gupta - Pareshan	PERSON
