Suraj Prakash
	PERSON
Kondapur	GPE
Hyderabad	GPE
Telangana 500084	GPE
Sep. 2017	DATE
Oct 2021	DATE
Electrical And Electronics Engineering	WORK_OF_ART
Jharkhand	GPE
D.A.V Public School	ORG
Sep. 2015	DATE
May 2017
	DATE
10th	ORDINAL
Bokaro Steel City	FAC
Jharkhand	GPE
Data Structures	ORG
SQL	ORG
Database Management	ORG
Analog	PERSON
Digital	ORG
− −	PERSON
Employee Management System | Core Java (Swing	ORG
AWT	ORG
JDBC	ORG
Employee Management System Java Project	ORG
− −	PERSON
Quiz-Application | Java, Desktop Based Application	ORG
Desktop Based Application	ORG
Java Swing	PERSON
Java and Abstract Window Tool-kit	ORG
Core Java	PERSON
Inheritance	GPE
4	CARDINAL
Rules	EVENT
Quiz Interface	ORG
Scoreboard	NORP
− −	PERSON
Apache Netbeans	ORG
Swing	PERSON
AWT	ORG
Java SE language	LAW
Loopback	ORG
Java Swing	PERSON
Client	PRODUCT
Controller	PERSON
Endurance-25min	PERSON
Accelerometer	GPE
GPS	ORG
Barometer Pressure Sensor	ORG
Compass	GPE
Lidar	GPE
UN	ORG
Aerial Vehicles	ORG
Jamshedpur	GPE
ECAD	ORG
ECAD	ORG
2D	CARDINAL
3D	ORG
SQL	ORG
Matlab	PERSON
Atom	ORG
BootStrap	ORG
Eclipse	PRODUCT
Linux	PERSON
GitHub	GPE
Bitbucket	GPE
WordPress	ORG
