Surya Prabha	PERSON
Achieve	ORG
PGD	ORG
Health Safety & Environment | National institute of Fire & Safety	ORG
Vizag	ORG
2019	DATE
84.5	CARDINAL
| Shri Vishnu Engineering College for Women	ORG
2014	DATE
7.51	CARDINAL
| Sri Chaitanya Jr. College	PERSON
Bhimavaram	PERSON
2012	DATE
91.1	CARDINAL
2012	DATE
GPA	ORG
9.2	CARDINAL
SQL Queries	ORG
Agile	GPE
MS Excel	GPE
Communication Skills	ORG
Good Team Player	PERSON
Hard Worker	PERSON
Seismic Analysis & Design	ORG
Slabs	GPE
Beams	ORG
Columns	GPE
Mandavilli	GPE
2015	DATE
National	ORG
the Godavari River	LOC
West Godavari District	LOC
East Godavari District	GPE
Andhra Pradesh	GPE
Andhra Pradesh	GPE
ACHIEVEMENTS & PARTICIPATIONS	ORG
National Student Symposium for Women	ORG
2017	DATE
Vishnu E-Moto Championship	WORK_OF_ART
SVECW 2016	ORG
WEALTH FROM WASTE	WORK_OF_ART
ISTE STUDENT CHAPTER	ORG
SVECW	ORG
INTERSTELLAR	ORG
Amateur Astronomy Association	ORG
SVECW	ORG
English	LANGUAGE
Telugu	GPE
Hindi	GPE
Yoga and Meditation	EVENT
Movies and Shows	WORK_OF_ART
Surya Prabha	PERSON
2	CARDINAL
