Swankit Shree 
	PERSON
Graphic Designer	PERSON
Animator	ORG
VFX Artist	ORG
https://www.behance.net/swankitshree	CARDINAL
Linkedin Link	PERSON
Lecture Dekho	PERSON
2D	TIME
Sakuja	GPE
Senior Graphic & Animation Designer	ORG
LD Care	ORG
28 December to 30th April	DATE
New Delhi	GPE
Adobe Photoshop	ORG
Adobe Illustrator	ORG
Audio Video Editing	ORG
Adobe Character Animation	ORG
Clone	ORG
Silhouette	PRODUCT
Equalizer	PRODUCT
Nuke	PRODUCT
Sahara Samay News Network	PERSON
2019 to 2020	DATE
Lakme Academy	ORG
Channels And Short Films 
 
	WORK_OF_ART
Website Design for Company Website	ORG
2d	CARDINAL
Greater Noida	ORG
2019 - 2022	DATE
State Board	ORG
59.5 %	PERCENT
2017	DATE
5.8	CARDINAL
2015	DATE
Word	GPE
PowerPoint	ORG
Suresh Kumar	PERSON
New Delhi	GPE
23/11/1999	DATE
Indian	NORP
Hindi	PERSON
English	LANGUAGE
