Manipal University Jaipur	ORG
8.73	CARDINAL
2024	CARDINAL
Jaipur	PERSON
Rajasthan	PERSON
Sasi	PERSON
9.84	CARDINAL
Physics	ORG
Chemistry	ORG
MPC	ORG
Secondary	ORDINAL
Sasi English Medium	ORG
10.00	CARDINAL
2017	DATE
Andhrapradesh	GPE
Deep	PERSON
CNN	ORG
React	PRODUCT
React	PRODUCT
Python	WORK_OF_ART
NumPy	GPE
Deep Learning	PERSON
HTML	GPE
CSS	ORG
JavaScript	ORG
JavaScript Frameworks/Libraries	PERSON
JavaScript	ORG
React	PRODUCT
Flutter	ORG
Dart	ORG
Microsoft Azure Cloud
Familiarity	ORG
Microsoft Azure	ORG
Trainee Intern	PERSON
Celebal Technologies	ORG
05/2023	CARDINAL
Rajasthan	PERSON
Azure Cloud	PRODUCT
Azure Cloud services	ORG
Python	ORG
Wictronix	PERSON
AI/ML	ORG
Salesforce CRM	PRODUCT
Customer 
Relationship Management	ORG
Salesforce	ORG
Oracle	GPE
Red Hat System 
Administration	ORG
Red Hat	ORG
Academy
	FAC
Wireless Essentials	ORG
UDEMY	ORG
AWARDS	ORG
Manipal University Jaipur	ORG
one	CARDINAL
50 percent	PERCENT
Fee Reimbursement	PERSON
English	LANGUAGE
Hindi	PERSON
Telugu	PERSON
